..##..##..##..##..##..##..##..##..##..##..
..##..##..##..##..##..##..##..##..##..##..
..........................................
..........................................
##..##..##..##..##..##..##..##..##..##..##
##..##..##..##..##..##..##..##..##..##..##
..........................................
..........................................
++..##..#.##.#..##..++++..##..#..##..#..##
++..##..#.##.#..##..++++..##..#..##..#..##
..........................................