.#.#.#.#.#.#.#.#.#.#.
.#.#.#.#.#.#.#.#.#.#.
.#.#.#.#.#.#.#.#.#.#.
.#.#.#.#.#.#.#.#.#.#.
.#.#.#.#.#.#.#.#.#.#.
.....................
++..##..#.##.#..## ++
.....................
 # # # # # # # # # #.
 +++..++...++...+++..