 # # # # # # # # # # 
 # # # # # # # # # # 
 # # # # # # # # # # 
 # # # # # # # # # # 
 # # # # # # # # # # 

++  ##  # ## #  ## ++

 # # # # # # # # # # 
 +++..++ . ++ . +++  